16
0 15 0
7 7 2 2
3113111131133333
2322331223000002
2222223023011220
2300301021112122
2331011211102222
2223101111333222
2022111111000022
2221131312222222
2232112203110222
2221212120111022
3222120211113222
2203232121222122
2223201212120222
2320021301211002
2002222210111112
2223101101130100