16
0 15 0
7 7 2 2
3111111111111111
2331231122323212
2230223222221122
2011222222121220
3312222221131212
3302222223101222
3110203022322220
3103110310222022
2102111202222222
3100232112222222
2310222222102222
3210222221121002
3110222223111332
2323220020321020
2220231022223302
2210001102101032