16
0 15 0
7 7 2 2
3111111111111111
2313131111111110
2020203313130302
2211122020203032
2113022202030302
3122122131121022
2221222203011122
2203023312110222
2230322002302222
2103022111012222
3012222111100202
3012221111112302
3012223113021212
3010210120202122
2131303011101022
2202021111101020
