16
15 0 2
7 7 2 2
3111111111111113
2123111131132222
2302211203003122
2222302113120202
0230212100231102
0221223131203102
2223030202112112
2222121313023102
2222230202122112
2222123101221102
2221220301212102
2212231301303012
2210202301231012
2312112101023030
2223211111100310
0020111111111030